NO ./assets/metal_wall.xpm
SO ./assets/portal_steel_wall.xpm
WE ./assets/red_brick_wall.xpm
EA ./assets/red_brick_wall.xpm

C 51,51,51
F 153,153,153

1 1 1 1 1 1
11111111111
1E000000001
10101D10101
01010101010