NO ./assets/metal_wall.xpm
EA ./assets/portal_steel_wall.xpm
WE ./assets/black_wall.xpm
SO ./assets/gray_brick_wall_2.xpm

C 51,51,51
F 153,153,153

        1111111111111111111111111
        100D00000K110000000000001
        1011000001110000100K00001
        10010000000D0000000000001
1111111110110M000111K0000000000K1
100000000K110000011101111D1111111
11110111111111011100000010001
1111D111111111D11101010010001
1100000011010101110000001K0011111
100K000000K0000011000000101000111
100000000000000011K10100100011111
11000001110101011111011110S0111
11110111 1110101 101111010001
1111D111 1111111 111111111111
1111D111
1111D111
1111D111
1111X111
11111111