NO ./assets/mark.xpm
SO ./assets/musk.xpm
WE ./assets/meta.xpm
EA ./assets/twitter.xpm

F 255,0,0
C 0,255,0

11111111111111111
10000000000000001
1000001111101D101
10000010000000001
10000010111111111
1000001010D000001
10000010101000S01
100000D0000000001
11111111111111110
