NO ./assets/mark.xpm
SO ./assets/musk.xpm
WE ./assets/meta.xpm
EA ./assets/twitter.xpm

F 255,0,0
C 0,255,0

1111
1001
10W1
1111
